#, , , ,#,#,#,#,#,#
#, ,#, , ,#,#,#, ,#
 , , ,#, ,#,#,#, ,#
#, , , , , , ,#, ,#
#,#,#,#, , , ,#, ,#
#, , , , , , , ,#,#
#,#,#,#, ,#,#,#, ,#
#, , , , , , , , ,#
#,#,#,#,#,#, ,#,#,#
#,#,#,#,#,#, , , ,
